{ 
  "tiles":[
    {"x": 0, "y": 0, "id": 0},
    {"x": 0, "y": 1, "id": 0},
    {"x": 1, "y": 0, "id": 0},
    {"x": 1, "y": 1, "id": 0},
    {"x": 2, "y": 1, "id": 0},
  ]
}
